
NO /nfs/homes/otamrani/Desktop/n/cub_3d/cub3d/ray_cast/images.xpm
SO /nfs/homes/otamrani/Desktop/n/cub_3d/cub3d/ray_cast/images.xpm
WE /nfs/homes/otamrani/Desktop/n/cub_3d/cub3d/ray_cast/images.xpm
EA /nfs/homes/otamrani/Desktop/n/cub_3d/cub3d/ray_cast/images.xpm

F 0,255,255
C 150,75,0

11111111111111111
100000N0001100001
10110000000100001
10010000000100001
10010000000100001
10010000000100001
11111111111111111