F 51,51,51
C 99, 99, 99


NO /Users/otamrani/Desktop/cub/the_newst/cub3d_bonus/tool_bonus/wall_web_spid.xpm
SO /Users/otamrani/Desktop/cub/the_newst/cub3d_bonus/tool_bonus/wall_animation.xpm
EA /Users/otamrani/Desktop/cub/the_newst/cub3d_bonus/tool_bonus/spider_wall1.xpm
WE /Users/otamrani/Desktop/cub/the_newst/cub3d_bonus/tool_bonus/cho3la.xpm
DO /Users/otamrani/Desktop/cub/the_newst/cub3d_bonus/tools1/wall.dooor.xpm

111111111111111111111111111111111111111111111111111111111111111111111111111111111111111111
10000000000011D1000000000000000000000000D000000000000000000000000000A000000000000111111111
101110011110100AA0011111000000111100011111000000AAAAAAAAAADAAAAAA1110D0011100001A1000D11111
1000100D00000000000000011000000000000A001111100000001100000AAAAAAAAA0AAADAAA1D1000001001111
1000100111111AAAAAAAAAAAAAAAAAA1D111000000AA00001111100111100D100000000000D11100001111D11111
100E000000000D00000000000000000000000000000000000AAAA00000001A111A0AAAAAAAAAAA0AAA111101111
1000000111111AAAAAAAAAAAA0AAAAD1100001111DA0A00100111000000000001100110000000000000111D1111
100010000D0000000000000000000000000000001A111A11000000000111110000000001111A111DAAAA00001111
11001101111000000011111AAAAAAAAAADAAAAAAA011111111D11A11AAAAAAAAAAAADAAAAAAAA00011D000AA11111
110001011111111A0011111000000000000011111DAAAAAAAA0AAAAAAAAD00000000000000000000000011111111111
1101010111100000001111100000011110001111100100000000000000000000111110001111AAAADAAA0000001111111111
11010101111000AAAAAAAAAA000000AAAA00111110010000A00AAAA001111100001000000001000D00011111111111
110100000D000000000000000001A100000000D000000AAAAA000010000000AAAAAAAAA000000111111111111111
111111111111111111111111111111111111111111111111111111111111111111111111111111111111111
