F 0, 191, 255
C 99, 99, 99


NO /Users/otamrani/Desktop/cub/the_newst/ray_cast/minimalism-simple-background-marvel-comics-marvel-vs-capcom-3-wallpaper-preview.xpm
SO /Users/otamrani/Desktop/cub/the_newst/ray_cast/spider-web-elizabeth-medley.xpm
EA /Users/otamrani/Desktop/cub/the_newst/ray_cast/image.xpm
WE /Users/otamrani/Desktop/cub/the_newst/ray_cast/img.xpm
DO ../texters/door.xpm

11111111111111111111111111111111111111111
10000000000011D10000000000000000000000001
10000001111010000011111000000111100011111
10000000000000000000000000000000000000001
10000001111000000011111000A00111100011111
1000000000001D100000000000000000000000001
10000001111000000011111000N00111100011111
10000000000000000000000000000000000000001
11000001111000000011111000000111100011111
11111111111111111111111111111111111111111
