
NO ./path_to_the_north_texture
SO ./path_to_the_south_texture
WE ./path_to_the_west_texture
EA ./path_to_the_east_texture

F 255,255,0
C 55,255,128

1111111111111111111
1000000000000100001
1111111111110N11101
1000000000000000101
1111111111111111101
1000000000000000001
1011111110011111101
1010000010010000001
1111011111111111111
1000000000000000001
1111111111111111111
