F 51,51,51
C 99, 99, 99


NO /Users/otamrani/Desktop/cub/the_newst/ray_cast/tool_bonus/wall_web_spid.xpm
SO /Users/otamrani/Desktop/cub/the_newst/ray_cast/tool_bonus/cho3la2.xpm
EA /Users/otamrani/Desktop/cub/the_newst/ray_cast/tool_bonus/spider_wall1.xpm
WE /Users/otamrani/Desktop/cub/the_newst/ray_cast/tool_bonus/wall_web_spid.xpm
DO /Users/otamrani/Desktop/cub/the_newst/ray_cast/tools1/wall.dooor.xpm

11111111111111111111111111111111111111111111111111111111111111111111111111111111111111
10000000000011D1000000000000000000000000100000000000000000000000000000000000000001111
1000000111101000001111100000011110001111100000011111111111111111000001110000111111111
10000000000000000000000110000000000000001111100000001100000111111111111111111110011111
1000000111111AAAAAAAAAAAAAAAAADAAAAAAAA001111111111111111100000000000111100011111111111
100E000000000D0000000000000000000000000000000001111100000001111111111111111111111111111
1000000111101AAAAAAAAAAAAAAAAAAAAAAAAAAAAADA0A001111110000000000011111100000000000111111
10000000000000000000000000000000000000001A1111110000000001111100000000111111111111111111111
11000001111000000011111000000111100011111A0111111111111111AAAAAAAAAAAAAAAAAAAAA00011111111
11000001111000000011111000000111100011111A010000000000000D00000000000000000000000011111111111
11000001111000000011111000000111100011111A01000000000000011111111100011111111100001111111111
11000001111000000011111000000111100011111A01000000000000011111000010000000010001111111111
11000001111000000011111000000111100011111A0000000000000001000000000000000000000001111111
111111111111111111111111111111111111111111111111111111111111111111111111111111111111111
