
NO ./path_to_the_north_texture
SO ./path_to_the_south_texture
WE ./path_to_the_west_texture
EA ./path_to_the_east_texture

F 255,255,0
C 55,255,128

11111111111111111111
1N000000000000000001
1011111111111111101
10000000000000000001
1011111111111111101
10000000000000000001
1011111111111111101
10000000000000000001
1011111111111111101
10000000000000000001
1011111111111111101
10000000000000000001
1011111111111111101
10000000000000000001
1011111111111111101
10000000000000000001
1011111111111111101
10000000000000000001
1011111111111111101
10000000000000000001
11111111111111111111
