
F 135,206,235

C 99,99,0
NO /Users/otamrani/Desktop/kl/ray_cast/bbbbb.xpm
SO /Users/otamrani/Desktop/kl/ray_cast/zzzz.xpm
EA /Users/otamrani/Desktop/kl/ray_cast/1.xpm
WE /Users/otamrani/Desktop/kl/ray_cast/b7yc7887.xpm

1111111111
1000000001
10000000011111111111
1000000001100000E001
10000000011111111111
1111111111
