
NO /Users/otamrani/Desktop/cb/qwerty/texters/so.xpm
SO /Users/otamrani/Desktop/cb/qwerty/texters/so.xpm
WE /Users/otamrani/Desktop/cb/qwerty/texters/so.xpm
EA /Users/otamrani/Desktop/cb/qwerty/texters/so.xpm

F 255,3,3
C 99,99,99

111111111111111111111111111111111
111111111011000001110000000000001
100000000011000001110111111111111
111101111111110111000000100011111
110000000000000000000101010010001
110000001101010111000000100011111
10000000000000001100000010001
10000000000000001101010010001
1100S00111010101111101111000111
11110111 1110101 101111010001
11111111 1111111 111111111111