
NO ./path_to_the_north_texture
SO ./path_to_the_south_texture
WE ./path_to_the_west_texture
EA ./path_to_the_east_texture

F 255,255,0
C 55,255,128

11111111111111111111
11000001000000000001
1100000100000000111
11000111111111111001
11000000000100000001
11100000000000000001
11100000000001N0001
1100001111000100001
1000000100110010001
1000000100110010001
1000000100110010001
1000000100110010001
1000000100110010001
1000000100110010001
1000000100110010001
11111111111111111111